111111111111111111
101010011011011111
100100P000100110C1
101101111011011101
10110E111001011001
100100000011000011
101101110011001001
100100000010101001
101101000011000011
101101110011010111
101110011001000001
101100110011011111
101110010001000001
101000001011011001
101101100001000001
101110100011010001
101100101001000001
101000110011010011
110111001011010001
111111111111111111