123456789
222222222
333333333
444444444
555555555
666666666
777777777
888888888
123456789