1111111111111111111111111
111111111CCC1111111111111
11111111CCECC111111111111
1100000000000000000111111
11000000CP000000000111111
1111111111111111111111111