111111111111
100010000001
10100P001001
100000001001
111111111111
