111111111111111
100010000000001
101000001000001
100000001000001
111111111111111
