111111111
1ECPPPPP1
111111111
