111111111111111111111111111
10E0G0G0000C00000C000000001
111001000000101001000010101
101001001010001001000G10101
1P0000000C00C000000000000C1
111111111111111111111111111
