1111111111111
1E00C000C00G1
1110101001001
101G100G10101
1P000C00000C1
1111111111111
