1111111111111
10CPE0000001
11111111111
111111111
11111111
1111111
111111
11111
1111
101
11
1