111111111111111111
101010011011C11111
10010000001C011C01
101101111011011101
101100111001011001
100100000011000011
1011011100110010C1
1001000000101010C1
101101000011000011
101101110011010111
1011100110010000C1
101100110011011111
101110010001000001
101000001011011001
101101100001000001
101110100011010P01
101100101001000001
101000110011010E11
110111001011C100C1
111111111111111111