111111111111111111111111111111111111111111111111111111111111111111111111111111111111111111111111111111111111111111111111111111111111111111111111111111111111111
100000000000000000000000000000000000000000000000000000000000000000000000000000000000000000000000000000000000000000000000000000000000000000000000000000000000001
111111111111111111111111110011111111110011111111111111100010101111111111111111111111011111111111111111111111001111111110011111111110101001010101111111111111111
111111111111111111111111110011111111110011111111111111100010101111111111111111111111011111111111111111111111001111111110011111111110101001010101111111111111111
111111111111111111111111110011111111110011111111111111100010101111111111111111111111011111111111111111111111001111111110011111111110101001010101111111111111111
111111111111111111111111110011111111110011111111111111100010101111111111111111111111011111111111111111111111001111111110011111111110101001010101111111111111111
111100000000000000000000000001111111110000000000000000000000001111000000000000111100011000000000000000000000001111110000011111111100000000000000011111000000111
111001101100000000000000000000111111111111111111111111100000000110000001110000011000011010001000000000001000001111100000011111111100001001010100001111000C00011
110001101100000000000000000000000011111111111111111111100000000000001011111010011000011000100000000000000010000111000000011111111010100000000000000111000100011
100000000000000000000000000000000000001111111111111111100010000000000000000000011001011010001000001001001000000000000E00000000000000001001010100000011001010001
11000011011000000000000000000000000000111111111111111110000000000000101000101001100001100010000000000000001000011100000P000000111010100000000000000000000100011
111000110110000000000000000000111100001111111111111111100000000110000000000000011000011010001000000000001000001111000000000000111100001001010100000000000000011
111100000000000000000000000001111100000000000000000000000000001111000000000000111100011000000000000000000000001111000000000000111100000000000000000011000000111
111111111111111111111111111111111111111111111111111111111111111111111111111111111111111111111111111111111111111111111111111111111111111111111111111111111111111
111111111111111111111111111111111111111111111111111111111111111111111111111111111111111111111111111111111111111111111111111111111111111111111111111111111111111